OOOOOOOOOOOOOOOO
OOOOOOOOOOOO   O
OOOOOOOOOOOO O O
OOOOOOOOOOOO O O
O       OOOO O O
O OOOOO OOOO O O
O OOOOO OOOO O O
O OOOOO OOOO O P
O OOOOOOOO   OOO
O OOOOOOOO OOOOO
O    OOOO  OOOOO
OOOO OOOO OOOOOO
O         OOOOOO
OOOOOOOOOOOOOOOO
OOOOOOOOOOOOOOOO
OOOOOOOOOOOOOOOO
 7
 7
 1
 0
