OOOOOOOOOOOOOOOO
O             OO
OOOOOO OOO OO OO
OO     OOO OO OO
OO OOOOOOO OO OO
OO OO      OO OO
OO    OOOOOO  OO
OOOOOOOOOOO O OO
OO      OO    OO
OOO OO OOO O OOO
OOO OO OOO O OOO
OOO OO OOO OOOOO
OOO OO OOO    OO
OOO OO OOO OO OO
P   OO  P     OO
OOOOOOOOOOOOOOOO
 1
 1
 1
 0
